"filename", "language", "ActionScript", "XML", "comment", "blank", "total"
"/home/michal-wyszynski/Desktop/u connect reverse eng/uConnext/src/climateapp_swf/ClimateApp.as", "ActionScript", 123, 0, 0, 26, 149
"/home/michal-wyszynski/Desktop/u connect reverse eng/uConnext/src/climateapp_swf/climateapp-app.xml", "XML", 0, 10, 340, 61, 411
"/home/michal-wyszynski/Desktop/u connect reverse eng/uConnext/src/climateapp_swf/ui/HorizontalSlider.as", "ActionScript", 107, 0, 8, 16, 131
"/home/michal-wyszynski/Desktop/u connect reverse eng/uConnext/src/climateapp_swf/ui/ImageToggleBtn.as", "ActionScript", 51, 0, 0, 10, 61
"/home/michal-wyszynski/Desktop/u connect reverse eng/uConnext/src/climateapp_swf/ui/Slider.as", "ActionScript", 181, 0, 9, 25, 215
"/home/michal-wyszynski/Desktop/u connect reverse eng/uConnext/src/main_swf/ModuleLink.xml", "XML", 0, 4, 0, 2, 6
"/home/michal-wyszynski/Desktop/u connect reverse eng/uConnext/src/main_swf/com/adobe/air/crypto/EncryptionKeyGenerator.as", "ActionScript", 107, 0, 162, 44, 313
"/home/michal-wyszynski/Desktop/u connect reverse eng/uConnext/src/main_swf/com/adobe/air/filesystem/FileMonitor.as", "ActionScript", 129, 0, 86, 31, 246
"/home/michal-wyszynski/Desktop/u connect reverse eng/uConnext/src/main_swf/com/adobe/air/filesystem/FileUtil.as", "ActionScript", 21, 0, 36, 6, 63
"/home/michal-wyszynski/Desktop/u connect reverse eng/uConnext/src/main_swf/com/adobe/air/filesystem/VolumeMonitor.as", "ActionScript", 99, 0, 65, 20, 184
"/home/michal-wyszynski/Desktop/u connect reverse eng/uConnext/src/main_swf/com/adobe/air/filesystem/events/FileMonitorEvent.as", "ActionScript", 25, 0, 31, 5, 61
"/home/michal-wyszynski/Desktop/u connect reverse eng/uConnext/src/main_swf/com/adobe/air/logging/FileTarget.as", "ActionScript", 47, 0, 37, 11, 95
"/home/michal-wyszynski/Desktop/u connect reverse eng/uConnext/src/main_swf/com/adobe/air/net/ResourceCache.as", "ActionScript", 99, 0, 35, 32, 166
"/home/michal-wyszynski/Desktop/u connect reverse eng/uConnext/src/main_swf/com/adobe/air/net/events/ResourceCacheEvent.as", "ActionScript", 29, 0, 31, 10, 70
"/home/michal-wyszynski/Desktop/u connect reverse eng/uConnext/src/main_swf/com/adobe/crypto/HMAC.as", "ActionScript", 55, 0, 58, 15, 128
"/home/michal-wyszynski/Desktop/u connect reverse eng/uConnext/src/main_swf/com/adobe/crypto/MD5.as", "ActionScript", 147, 0, 108, 27, 282
"/home/michal-wyszynski/Desktop/u connect reverse eng/uConnext/src/main_swf/com/adobe/crypto/MD5Stream.as", "ActionScript", 209, 0, 139, 54, 402
"/home/michal-wyszynski/Desktop/u connect reverse eng/uConnext/src/main_swf/com/adobe/crypto/SHA1.as", "ActionScript", 155, 0, 100, 35, 290
"/home/michal-wyszynski/Desktop/u connect reverse eng/uConnext/src/main_swf/com/adobe/crypto/SHA224.as", "ActionScript", 144, 0, 87, 27, 258
"/home/michal-wyszynski/Desktop/u connect reverse eng/uConnext/src/main_swf/com/adobe/crypto/SHA256.as", "ActionScript", 147, 0, 87, 28, 262
"/home/michal-wyszynski/Desktop/u connect reverse eng/uConnext/src/main_swf/com/adobe/crypto/WSSEUsernameToken.as", "ActionScript", 51, 0, 54, 9, 114
"/home/michal-wyszynski/Desktop/u connect reverse eng/uConnext/src/main_swf/com/adobe/errors/IllegalStateError.as", "ActionScript", 10, 0, 52, 1, 63
"/home/michal-wyszynski/Desktop/u connect reverse eng/uConnext/src/main_swf/com/adobe/fileformats/vcard/Address.as", "ActionScript", 15, 0, 31, 1, 47
"/home/michal-wyszynski/Desktop/u connect reverse eng/uConnext/src/main_swf/com/adobe/fileformats/vcard/Email.as", "ActionScript", 8, 0, 31, 0, 39
"/home/michal-wyszynski/Desktop/u connect reverse eng/uConnext/src/main_swf/com/adobe/fileformats/vcard/Phone.as", "ActionScript", 8, 0, 31, 0, 39
"/home/michal-wyszynski/Desktop/u connect reverse eng/uConnext/src/main_swf/com/adobe/fileformats/vcard/VCard.as", "ActionScript", 21, 0, 31, 2, 54
"/home/michal-wyszynski/Desktop/u connect reverse eng/uConnext/src/main_swf/com/adobe/fileformats/vcard/VCardParser.as", "ActionScript", 206, 0, 33, 7, 246
"/home/michal-wyszynski/Desktop/u connect reverse eng/uConnext/src/main_swf/com/adobe/images/BitString.as", "ActionScript", 8, 0, 31, 0, 39
"/home/michal-wyszynski/Desktop/u connect reverse eng/uConnext/src/main_swf/com/adobe/images/JPGEncoder.as", "ActionScript", 511, 0, 78, 60, 649
"/home/michal-wyszynski/Desktop/u connect reverse eng/uConnext/src/main_swf/com/adobe/images/PNGEncoder.as", "ActionScript", 88, 0, 50, 3, 141
"/home/michal-wyszynski/Desktop/u connect reverse eng/uConnext/src/main_swf/com/adobe/net/DynamicURLLoader.as", "ActionScript", 11, 0, 42, 2, 55
"/home/michal-wyszynski/Desktop/u connect reverse eng/uConnext/src/main_swf/com/adobe/net/IURIResolver.as", "ActionScript", 7, 0, 68, 1, 76
"/home/michal-wyszynski/Desktop/u connect reverse eng/uConnext/src/main_swf/com/adobe/net/MimeTypeMap.as", "ActionScript", 157, 0, 40, 3, 200
"/home/michal-wyszynski/Desktop/u connect reverse eng/uConnext/src/main_swf/com/adobe/net/URI.as", "ActionScript", 1128, 0, 1016, 322, 2466
"/home/michal-wyszynski/Desktop/u connect reverse eng/uConnext/src/main_swf/com/adobe/net/URIEncodingBitmap.as", "ActionScript", 54, 0, 73, 12, 139
"/home/michal-wyszynski/Desktop/u connect reverse eng/uConnext/src/main_swf/com/adobe/net/proxies/RFC2817Socket.as", "ActionScript", 120, 0, 64, 14, 198
"/home/michal-wyszynski/Desktop/u connect reverse eng/uConnext/src/main_swf/com/adobe/protocols/dict/Database.as", "ActionScript", 29, 0, 31, 6, 66
"/home/michal-wyszynski/Desktop/u connect reverse eng/uConnext/src/main_swf/com/adobe/protocols/dict/Definition.as", "ActionScript", 33, 0, 31, 7, 71
"/home/michal-wyszynski/Desktop/u connect reverse eng/uConnext/src/main_swf/com/adobe/protocols/dict/Dict.as", "ActionScript", 282, 0, 45, 33, 360
"/home/michal-wyszynski/Desktop/u connect reverse eng/uConnext/src/main_swf/com/adobe/protocols/dict/DictionaryServer.as", "ActionScript", 24, 0, 31, 5, 60
"/home/michal-wyszynski/Desktop/u connect reverse eng/uConnext/src/main_swf/com/adobe/protocols/dict/MatchStrategy.as", "ActionScript", 29, 0, 31, 6, 66
"/home/michal-wyszynski/Desktop/u connect reverse eng/uConnext/src/main_swf/com/adobe/protocols/dict/Response.as", "ActionScript", 33, 0, 31, 7, 71
"/home/michal-wyszynski/Desktop/u connect reverse eng/uConnext/src/main_swf/com/adobe/protocols/dict/events/ConnectedEvent.as", "ActionScript", 18, 0, 31, 4, 53
"/home/michal-wyszynski/Desktop/u connect reverse eng/uConnext/src/main_swf/com/adobe/protocols/dict/events/DatabaseEvent.as", "ActionScript", 28, 0, 31, 8, 67
"/home/michal-wyszynski/Desktop/u connect reverse eng/uConnext/src/main_swf/com/adobe/protocols/dict/events/DefinitionEvent.as", "ActionScript", 29, 0, 31, 10, 70
"/home/michal-wyszynski/Desktop/u connect reverse eng/uConnext/src/main_swf/com/adobe/protocols/dict/events/DefinitionHeaderEvent.as", "ActionScript", 29, 0, 31, 9, 69
"/home/michal-wyszynski/Desktop/u connect reverse eng/uConnext/src/main_swf/com/adobe/protocols/dict/events/DictionaryServerEvent.as", "ActionScript", 29, 0, 31, 9, 69
"/home/michal-wyszynski/Desktop/u connect reverse eng/uConnext/src/main_swf/com/adobe/protocols/dict/events/DisconnectedEvent.as", "ActionScript", 18, 0, 31, 6, 55
"/home/michal-wyszynski/Desktop/u connect reverse eng/uConnext/src/main_swf/com/adobe/protocols/dict/events/ErrorEvent.as", "ActionScript", 38, 0, 31, 11, 80
"/home/michal-wyszynski/Desktop/u connect reverse eng/uConnext/src/main_swf/com/adobe/protocols/dict/events/MatchEvent.as", "ActionScript", 28, 0, 31, 8, 67
"/home/michal-wyszynski/Desktop/u connect reverse eng/uConnext/src/main_swf/com/adobe/protocols/dict/events/MatchStrategiesEvent.as", "ActionScript", 30, 0, 31, 9, 70
"/home/michal-wyszynski/Desktop/u connect reverse eng/uConnext/src/main_swf/com/adobe/protocols/dict/events/NoMatchEvent.as", "ActionScript", 18, 0, 31, 5, 54
"/home/michal-wyszynski/Desktop/u connect reverse eng/uConnext/src/main_swf/com/adobe/protocols/dict/util/CompleteResponseEvent.as", "ActionScript", 29, 0, 31, 8, 68
"/home/michal-wyszynski/Desktop/u connect reverse eng/uConnext/src/main_swf/com/adobe/protocols/dict/util/SocketHelper.as", "ActionScript", 44, 0, 31, 6, 81
"/home/michal-wyszynski/Desktop/u connect reverse eng/uConnext/src/main_swf/com/adobe/serialization/json/JSON.as", "ActionScript", 14, 0, 67, 5, 86
"/home/michal-wyszynski/Desktop/u connect reverse eng/uConnext/src/main_swf/com/adobe/serialization/json/JSONDecoder.as", "ActionScript", 183, 0, 125, 45, 353
"/home/michal-wyszynski/Desktop/u connect reverse eng/uConnext/src/main_swf/com/adobe/serialization/json/JSONEncoder.as", "ActionScript", 145, 0, 137, 41, 323
"/home/michal-wyszynski/Desktop/u connect reverse eng/uConnext/src/main_swf/com/adobe/serialization/json/JSONParseError.as", "ActionScript", 23, 0, 61, 8, 92
"/home/michal-wyszynski/Desktop/u connect reverse eng/uConnext/src/main_swf/com/adobe/serialization/json/JSONToken.as", "ActionScript", 20, 0, 64, 8, 92
"/home/michal-wyszynski/Desktop/u connect reverse eng/uConnext/src/main_swf/com/adobe/serialization/json/JSONTokenType.as", "ActionScript", 19, 0, 35, 15, 69
"/home/michal-wyszynski/Desktop/u connect reverse eng/uConnext/src/main_swf/com/adobe/serialization/json/JSONTokenizer.as", "ActionScript", 403, 0, 207, 99, 709
"/home/michal-wyszynski/Desktop/u connect reverse eng/uConnext/src/main_swf/com/adobe/utils/ArrayUtil.as", "ActionScript", 57, 0, 114, 17, 188
"/home/michal-wyszynski/Desktop/u connect reverse eng/uConnext/src/main_swf/com/adobe/utils/DateUtil.as", "ActionScript", 365, 0, 297, 40, 702
"/home/michal-wyszynski/Desktop/u connect reverse eng/uConnext/src/main_swf/com/adobe/utils/DictionaryUtil.as", "ActionScript", 25, 0, 53, 9, 87
"/home/michal-wyszynski/Desktop/u connect reverse eng/uConnext/src/main_swf/com/adobe/utils/IntUtil.as", "ActionScript", 28, 0, 62, 9, 99
"/home/michal-wyszynski/Desktop/u connect reverse eng/uConnext/src/main_swf/com/adobe/utils/NumberFormatter.as", "ActionScript", 15, 0, 53, 6, 74
"/home/michal-wyszynski/Desktop/u connect reverse eng/uConnext/src/main_swf/com/adobe/utils/StringUtil.as", "ActionScript", 66, 0, 159, 14, 239
"/home/michal-wyszynski/Desktop/u connect reverse eng/uConnext/src/main_swf/com/adobe/utils/XMLUtil.as", "ActionScript", 49, 0, 104, 15, 168
"/home/michal-wyszynski/Desktop/u connect reverse eng/uConnext/src/main_swf/com/adobe/webapis/ServiceBase.as", "ActionScript", 10, 0, 34, 4, 48
"/home/michal-wyszynski/Desktop/u connect reverse eng/uConnext/src/main_swf/com/adobe/webapis/URLLoaderBase.as", "ActionScript", 33, 0, 65, 10, 108
"/home/michal-wyszynski/Desktop/u connect reverse eng/uConnext/src/main_swf/com/adobe/webapis/events/ServiceEvent.as", "ActionScript", 27, 0, 45, 10, 82
"/home/michal-wyszynski/Desktop/u connect reverse eng/uConnext/src/main_swf/com/harman/framework/BufferControl/BufferControlTypes.as", "ActionScript", 48, 0, 0, 40, 88
"/home/michal-wyszynski/Desktop/u connect reverse eng/uConnext/src/main_swf/com/harman/framework/BufferControl/BufferController.as", "ActionScript", 1502, 0, 0, 111, 1613
"/home/michal-wyszynski/Desktop/u connect reverse eng/uConnext/src/main_swf/com/harman/framework/BufferControl/FrameRequestCtrl.as", "ActionScript", 61, 0, 0, 15, 76
"/home/michal-wyszynski/Desktop/u connect reverse eng/uConnext/src/main_swf/com/harman/framework/BufferControl/FrameRequestReturn.as", "ActionScript", 15, 0, 0, 7, 22
"/home/michal-wyszynski/Desktop/u connect reverse eng/uConnext/src/main_swf/com/harman/framework/BufferControl/IDataProvider.as", "ActionScript", 9, 0, 0, 4, 13
"/home/michal-wyszynski/Desktop/u connect reverse eng/uConnext/src/main_swf/com/harman/framework/BufferControl/ListBuffer.as", "ActionScript", 74, 0, 0, 17, 91
"/home/michal-wyszynski/Desktop/u connect reverse eng/uConnext/src/main_swf/com/harman/framework/controller/IList.as", "ActionScript", 12, 0, 0, 7, 19
"/home/michal-wyszynski/Desktop/u connect reverse eng/uConnext/src/main_swf/com/harman/framework/controller/ListController.as", "ActionScript", 555, 0, 0, 67, 622
"/home/michal-wyszynski/Desktop/u connect reverse eng/uConnext/src/main_swf/com/harman/framework/controller/ListControllerBuffer.as", "ActionScript", 507, 0, 0, 69, 576
"/home/michal-wyszynski/Desktop/u connect reverse eng/uConnext/src/main_swf/com/harman/moduleLink/AMS.as", "ActionScript", 142, 0, 0, 23, 165
"/home/michal-wyszynski/Desktop/u connect reverse eng/uConnext/src/main_swf/com/harman/moduleLink/AmsFileInfo.as", "ActionScript", 117, 0, 0, 23, 140
"/home/michal-wyszynski/Desktop/u connect reverse eng/uConnext/src/main_swf/com/harman/moduleLink/AntiTheft.as", "ActionScript", 224, 0, 0, 40, 264
"/home/michal-wyszynski/Desktop/u connect reverse eng/uConnext/src/main_swf/com/harman/moduleLink/AppManager.as", "ActionScript", 780, 0, 0, 95, 875
"/home/michal-wyszynski/Desktop/u connect reverse eng/uConnext/src/main_swf/com/harman/moduleLink/AudioMixerManager.as", "ActionScript", 388, 0, 0, 63, 451
"/home/michal-wyszynski/Desktop/u connect reverse eng/uConnext/src/main_swf/com/harman/moduleLink/BeaconDSRCHMI.as", "ActionScript", 573, 0, 0, 130, 703
"/home/michal-wyszynski/Desktop/u connect reverse eng/uConnext/src/main_swf/com/harman/moduleLink/CVPDemo.as", "ActionScript", 719, 0, 0, 100, 819
"/home/michal-wyszynski/Desktop/u connect reverse eng/uConnext/src/main_swf/com/harman/moduleLink/CameraUpdate.as", "ActionScript", 106, 0, 0, 19, 125
"/home/michal-wyszynski/Desktop/u connect reverse eng/uConnext/src/main_swf/com/harman/moduleLink/ConnectionManager.as", "ActionScript", 227, 0, 0, 27, 254
"/home/michal-wyszynski/Desktop/u connect reverse eng/uConnext/src/main_swf/com/harman/moduleLink/DABApp.as", "ActionScript", 115, 0, 0, 21, 136
"/home/michal-wyszynski/Desktop/u connect reverse eng/uConnext/src/main_swf/com/harman/moduleLink/DABTunerControl.as", "ActionScript", 203, 0, 0, 38, 241
"/home/michal-wyszynski/Desktop/u connect reverse eng/uConnext/src/main_swf/com/harman/moduleLink/DABTunerFollowMaster.as", "ActionScript", 134, 0, 0, 27, 161
"/home/michal-wyszynski/Desktop/u connect reverse eng/uConnext/src/main_swf/com/harman/moduleLink/DABTunerStation.as", "ActionScript", 408, 0, 0, 61, 469
"/home/michal-wyszynski/Desktop/u connect reverse eng/uConnext/src/main_swf/com/harman/moduleLink/DBusTraceMonitor.as", "ActionScript", 180, 0, 0, 30, 210
"/home/michal-wyszynski/Desktop/u connect reverse eng/uConnext/src/main_swf/com/harman/moduleLink/Diagnostics.as", "ActionScript", 461, 0, 0, 47, 508
"/home/michal-wyszynski/Desktop/u connect reverse eng/uConnext/src/main_swf/com/harman/moduleLink/DisplayManager.as", "ActionScript", 122, 0, 0, 24, 146
"/home/michal-wyszynski/Desktop/u connect reverse eng/uConnext/src/main_swf/com/harman/moduleLink/ECallSvc.as", "ActionScript", 144, 0, 0, 27, 171
"/home/michal-wyszynski/Desktop/u connect reverse eng/uConnext/src/main_swf/com/harman/moduleLink/HMIRequest.as", "ActionScript", 425, 0, 0, 41, 466
"/home/michal-wyszynski/Desktop/u connect reverse eng/uConnext/src/main_swf/com/harman/moduleLink/IPAddressInfo.as", "ActionScript", 225, 0, 0, 29, 254
"/home/michal-wyszynski/Desktop/u connect reverse eng/uConnext/src/main_swf/com/harman/moduleLink/KanjiHMI.as", "ActionScript", 262, 0, 0, 44, 306
"/home/michal-wyszynski/Desktop/u connect reverse eng/uConnext/src/main_swf/com/harman/moduleLink/Location.as", "ActionScript", 101, 0, 0, 15, 116
"/home/michal-wyszynski/Desktop/u connect reverse eng/uConnext/src/main_swf/com/harman/moduleLink/OmapTemp.as", "ActionScript", 74, 0, 0, 16, 90
"/home/michal-wyszynski/Desktop/u connect reverse eng/uConnext/src/main_swf/com/harman/moduleLink/PPS.as", "ActionScript", 174, 0, 0, 32, 206
"/home/michal-wyszynski/Desktop/u connect reverse eng/uConnext/src/main_swf/com/harman/moduleLink/PerformanceInfo.as", "ActionScript", 86, 0, 0, 16, 102
"/home/michal-wyszynski/Desktop/u connect reverse eng/uConnext/src/main_swf/com/harman/moduleLink/Persistency.as", "ActionScript", 75, 0, 0, 14, 89
"/home/michal-wyszynski/Desktop/u connect reverse eng/uConnext/src/main_swf/com/harman/moduleLink/Rse.as", "ActionScript", 582, 0, 0, 97, 679
"/home/michal-wyszynski/Desktop/u connect reverse eng/uConnext/src/main_swf/com/harman/moduleLink/SierraUpdate.as", "ActionScript", 109, 0, 0, 22, 131
"/home/michal-wyszynski/Desktop/u connect reverse eng/uConnext/src/main_swf/com/harman/moduleLink/SoftwareUpdate.as", "ActionScript", 271, 0, 0, 58, 329
"/home/michal-wyszynski/Desktop/u connect reverse eng/uConnext/src/main_swf/com/harman/moduleLink/SoftwareUpdateDatabase.as", "ActionScript", 174, 0, 0, 34, 208
"/home/michal-wyszynski/Desktop/u connect reverse eng/uConnext/src/main_swf/com/harman/moduleLink/VehicleStatus.as", "ActionScript", 357, 0, 0, 50, 407
"/home/michal-wyszynski/Desktop/u connect reverse eng/uConnext/src/main_swf/com/harman/moduleLink/VersionInfo.as", "ActionScript", 212, 0, 0, 46, 258
"/home/michal-wyszynski/Desktop/u connect reverse eng/uConnext/src/main_swf/com/harman/moduleLink/VicsDSRCEtcDiagHMI.as", "ActionScript", 211, 0, 0, 40, 251
"/home/michal-wyszynski/Desktop/u connect reverse eng/uConnext/src/main_swf/com/harman/moduleLink/VicsDiagEngMenuHMI.as", "ActionScript", 189, 0, 0, 35, 224
"/home/michal-wyszynski/Desktop/u connect reverse eng/uConnext/src/main_swf/com/harman/moduleLink/VicsEtcHMI.as", "ActionScript", 307, 0, 0, 60, 367
"/home/michal-wyszynski/Desktop/u connect reverse eng/uConnext/src/main_swf/com/harman/moduleLink/VicsFMHMI.as", "ActionScript", 338, 0, 0, 70, 408
"/home/michal-wyszynski/Desktop/u connect reverse eng/uConnext/src/main_swf/com/harman/moduleLink/VicsTunerHMI.as", "ActionScript", 288, 0, 0, 66, 354
"/home/michal-wyszynski/Desktop/u connect reverse eng/uConnext/src/main_swf/com/harman/moduleLink/WiFiService.as", "ActionScript", 860, 0, 0, 87, 947
"/home/michal-wyszynski/Desktop/u connect reverse eng/uConnext/src/main_swf/com/harman/moduleLink/iPodTagger.as", "ActionScript", 327, 0, 0, 46, 373
"/home/michal-wyszynski/Desktop/u connect reverse eng/uConnext/src/main_swf/com/harman/moduleLinkAPI/AMSEvent.as", "ActionScript", 19, 0, 0, 10, 29
"/home/michal-wyszynski/Desktop/u connect reverse eng/uConnext/src/main_swf/com/harman/moduleLinkAPI/AmsInfoEvent.as", "ActionScript", 14, 0, 0, 5, 19
"/home/michal-wyszynski/Desktop/u connect reverse eng/uConnext/src/main_swf/com/harman/moduleLinkAPI/AntiTheftEvent.as", "ActionScript", 21, 0, 0, 13, 34
"/home/michal-wyszynski/Desktop/u connect reverse eng/uConnext/src/main_swf/com/harman/moduleLinkAPI/AppManagerEvent.as", "ActionScript", 32, 0, 0, 23, 55
"/home/michal-wyszynski/Desktop/u connect reverse eng/uConnext/src/main_swf/com/harman/moduleLinkAPI/Applet.as", "ActionScript", 27, 0, 0, 18, 45
"/home/michal-wyszynski/Desktop/u connect reverse eng/uConnext/src/main_swf/com/harman/moduleLinkAPI/AudioMixerManagerEvent.as", "ActionScript", 19, 0, 0, 11, 30
"/home/michal-wyszynski/Desktop/u connect reverse eng/uConnext/src/main_swf/com/harman/moduleLinkAPI/BeaconDSRCHMIEvent.as", "ActionScript", 45, 0, 0, 36, 81
"/home/michal-wyszynski/Desktop/u connect reverse eng/uConnext/src/main_swf/com/harman/moduleLinkAPI/BeaconDSRCID.as", "ActionScript", 133, 0, 0, 37, 170
"/home/michal-wyszynski/Desktop/u connect reverse eng/uConnext/src/main_swf/com/harman/moduleLinkAPI/BeaconDSRCTime.as", "ActionScript", 14, 0, 0, 6, 20
"/home/michal-wyszynski/Desktop/u connect reverse eng/uConnext/src/main_swf/com/harman/moduleLinkAPI/CVPDemoEvent.as", "ActionScript", 29, 0, 0, 20, 49
"/home/michal-wyszynski/Desktop/u connect reverse eng/uConnext/src/main_swf/com/harman/moduleLinkAPI/CameraEvent.as", "ActionScript", 15, 0, 0, 6, 21
"/home/michal-wyszynski/Desktop/u connect reverse eng/uConnext/src/main_swf/com/harman/moduleLinkAPI/ConnectionManagerEvent.as", "ActionScript", 24, 0, 0, 15, 39
"/home/michal-wyszynski/Desktop/u connect reverse eng/uConnext/src/main_swf/com/harman/moduleLinkAPI/DABEvent.as", "ActionScript", 23, 0, 0, 15, 38
"/home/michal-wyszynski/Desktop/u connect reverse eng/uConnext/src/main_swf/com/harman/moduleLinkAPI/DABIndexIdHelper.as", "ActionScript", 53, 0, 0, 45, 98
"/home/michal-wyszynski/Desktop/u connect reverse eng/uConnext/src/main_swf/com/harman/moduleLinkAPI/DABPreset.as", "ActionScript", 64, 0, 0, 15, 79
"/home/michal-wyszynski/Desktop/u connect reverse eng/uConnext/src/main_swf/com/harman/moduleLinkAPI/DABRequestStatus.as", "ActionScript", 14, 0, 0, 4, 18
"/home/michal-wyszynski/Desktop/u connect reverse eng/uConnext/src/main_swf/com/harman/moduleLinkAPI/DABTunerControlVersions.as", "ActionScript", 19, 0, 0, 5, 24
"/home/michal-wyszynski/Desktop/u connect reverse eng/uConnext/src/main_swf/com/harman/moduleLinkAPI/DABTunerStationInstance.as", "ActionScript", 110, 0, 0, 16, 126
"/home/michal-wyszynski/Desktop/u connect reverse eng/uConnext/src/main_swf/com/harman/moduleLinkAPI/DBusTraceMonitorEvent.as", "ActionScript", 13, 0, 0, 5, 18
"/home/michal-wyszynski/Desktop/u connect reverse eng/uConnext/src/main_swf/com/harman/moduleLinkAPI/DMBSeekTypes.as", "ActionScript", 12, 0, 0, 4, 16
"/home/michal-wyszynski/Desktop/u connect reverse eng/uConnext/src/main_swf/com/harman/moduleLinkAPI/DiagnosticsEvent.as", "ActionScript", 19, 0, 0, 10, 29
"/home/michal-wyszynski/Desktop/u connect reverse eng/uConnext/src/main_swf/com/harman/moduleLinkAPI/DisplayManagerEvent.as", "ActionScript", 14, 0, 0, 6, 20
"/home/michal-wyszynski/Desktop/u connect reverse eng/uConnext/src/main_swf/com/harman/moduleLinkAPI/ECallSvcEvent.as", "ActionScript", 14, 0, 0, 5, 19
"/home/michal-wyszynski/Desktop/u connect reverse eng/uConnext/src/main_swf/com/harman/moduleLinkAPI/EtcID.as", "ActionScript", 106, 0, 0, 42, 148
"/home/michal-wyszynski/Desktop/u connect reverse eng/uConnext/src/main_swf/com/harman/moduleLinkAPI/HMIRequestEvent.as", "ActionScript", 38, 0, 0, 29, 67
"/home/michal-wyszynski/Desktop/u connect reverse eng/uConnext/src/main_swf/com/harman/moduleLinkAPI/HdBER.as", "ActionScript", 44, 0, 0, 18, 62
"/home/michal-wyszynski/Desktop/u connect reverse eng/uConnext/src/main_swf/com/harman/moduleLinkAPI/HdPerformance.as", "ActionScript", 24, 0, 0, 8, 32
"/home/michal-wyszynski/Desktop/u connect reverse eng/uConnext/src/main_swf/com/harman/moduleLinkAPI/IAMS.as", "ActionScript", 10, 0, 0, 5, 15
"/home/michal-wyszynski/Desktop/u connect reverse eng/uConnext/src/main_swf/com/harman/moduleLinkAPI/IAmsFileInfo.as", "ActionScript", 14, 0, 0, 9, 23
"/home/michal-wyszynski/Desktop/u connect reverse eng/uConnext/src/main_swf/com/harman/moduleLinkAPI/IAntiTheft.as", "ActionScript", 19, 0, 0, 14, 33
"/home/michal-wyszynski/Desktop/u connect reverse eng/uConnext/src/main_swf/com/harman/moduleLinkAPI/IAppManager.as", "ActionScript", 43, 0, 0, 38, 81
"/home/michal-wyszynski/Desktop/u connect reverse eng/uConnext/src/main_swf/com/harman/moduleLinkAPI/IAudioMixerManager.as", "ActionScript", 33, 0, 0, 28, 61
"/home/michal-wyszynski/Desktop/u connect reverse eng/uConnext/src/main_swf/com/harman/moduleLinkAPI/IBeaconDSRCHMI.as", "ActionScript", 61, 0, 0, 56, 117
"/home/michal-wyszynski/Desktop/u connect reverse eng/uConnext/src/main_swf/com/harman/moduleLinkAPI/ICVPDemo.as", "ActionScript", 64, 0, 0, 59, 123
"/home/michal-wyszynski/Desktop/u connect reverse eng/uConnext/src/main_swf/com/harman/moduleLinkAPI/ICameraUpdate.as", "ActionScript", 9, 0, 0, 4, 13
"/home/michal-wyszynski/Desktop/u connect reverse eng/uConnext/src/main_swf/com/harman/moduleLinkAPI/IConnectionManager.as", "ActionScript", 16, 0, 0, 11, 27
"/home/michal-wyszynski/Desktop/u connect reverse eng/uConnext/src/main_swf/com/harman/moduleLinkAPI/IDABApp.as", "ActionScript", 9, 0, 0, 4, 13
"/home/michal-wyszynski/Desktop/u connect reverse eng/uConnext/src/main_swf/com/harman/moduleLinkAPI/IDABTunerControl.as", "ActionScript", 20, 0, 0, 15, 35
"/home/michal-wyszynski/Desktop/u connect reverse eng/uConnext/src/main_swf/com/harman/moduleLinkAPI/IDABTunerFollowMaster.as", "ActionScript", 12, 0, 0, 7, 19
"/home/michal-wyszynski/Desktop/u connect reverse eng/uConnext/src/main_swf/com/harman/moduleLinkAPI/IDABTunerStation.as", "ActionScript", 26, 0, 0, 21, 47
"/home/michal-wyszynski/Desktop/u connect reverse eng/uConnext/src/main_swf/com/harman/moduleLinkAPI/IDBusTraceMonitor.as", "ActionScript", 14, 0, 0, 9, 23
"/home/michal-wyszynski/Desktop/u connect reverse eng/uConnext/src/main_swf/com/harman/moduleLinkAPI/IDiagnostics.as", "ActionScript", 28, 0, 0, 22, 50
"/home/michal-wyszynski/Desktop/u connect reverse eng/uConnext/src/main_swf/com/harman/moduleLinkAPI/IDisplayManager.as", "ActionScript", 12, 0, 0, 7, 19
"/home/michal-wyszynski/Desktop/u connect reverse eng/uConnext/src/main_swf/com/harman/moduleLinkAPI/IECallSvc.as", "ActionScript", 14, 0, 0, 9, 23
"/home/michal-wyszynski/Desktop/u connect reverse eng/uConnext/src/main_swf/com/harman/moduleLinkAPI/IHMIRequest.as", "ActionScript", 27, 0, 0, 22, 49
"/home/michal-wyszynski/Desktop/u connect reverse eng/uConnext/src/main_swf/com/harman/moduleLinkAPI/IIPAddressInfo.as", "ActionScript", 17, 0, 0, 12, 29
"/home/michal-wyszynski/Desktop/u connect reverse eng/uConnext/src/main_swf/com/harman/moduleLinkAPI/IKanjiHMI.as", "ActionScript", 24, 0, 0, 19, 43
"/home/michal-wyszynski/Desktop/u connect reverse eng/uConnext/src/main_swf/com/harman/moduleLinkAPI/ILocation.as", "ActionScript", 9, 0, 0, 4, 13
"/home/michal-wyszynski/Desktop/u connect reverse eng/uConnext/src/main_swf/com/harman/moduleLinkAPI/INaviSyncTool.as", "ActionScript", 8, 0, 0, 3, 11
"/home/michal-wyszynski/Desktop/u connect reverse eng/uConnext/src/main_swf/com/harman/moduleLinkAPI/IOmapTemp.as", "ActionScript", 9, 0, 0, 4, 13
"/home/michal-wyszynski/Desktop/u connect reverse eng/uConnext/src/main_swf/com/harman/moduleLinkAPI/IPAddressInfoEvent.as", "ActionScript", 17, 0, 0, 8, 25
"/home/michal-wyszynski/Desktop/u connect reverse eng/uConnext/src/main_swf/com/harman/moduleLinkAPI/IPPS.as", "ActionScript", 13, 0, 0, 8, 21
"/home/michal-wyszynski/Desktop/u connect reverse eng/uConnext/src/main_swf/com/harman/moduleLinkAPI/IPerformanceInfo.as", "ActionScript", 9, 0, 0, 4, 13
"/home/michal-wyszynski/Desktop/u connect reverse eng/uConnext/src/main_swf/com/harman/moduleLinkAPI/IPersistency.as", "ActionScript", 9, 0, 0, 4, 13
"/home/michal-wyszynski/Desktop/u connect reverse eng/uConnext/src/main_swf/com/harman/moduleLinkAPI/IPodTagInfo.as", "ActionScript", 59, 0, 0, 14, 73
"/home/michal-wyszynski/Desktop/u connect reverse eng/uConnext/src/main_swf/com/harman/moduleLinkAPI/IPodTaggerEvent.as", "ActionScript", 37, 0, 0, 22, 59
"/home/michal-wyszynski/Desktop/u connect reverse eng/uConnext/src/main_swf/com/harman/moduleLinkAPI/IRse.as", "ActionScript", 56, 0, 0, 51, 107
"/home/michal-wyszynski/Desktop/u connect reverse eng/uConnext/src/main_swf/com/harman/moduleLinkAPI/ISierraUpdate.as", "ActionScript", 11, 0, 0, 6, 17
"/home/michal-wyszynski/Desktop/u connect reverse eng/uConnext/src/main_swf/com/harman/moduleLinkAPI/ISoftwareUpdate.as", "ActionScript", 29, 0, 0, 24, 53
"/home/michal-wyszynski/Desktop/u connect reverse eng/uConnext/src/main_swf/com/harman/moduleLinkAPI/IVehicleStatus.as", "ActionScript", 24, 0, 0, 19, 43
"/home/michal-wyszynski/Desktop/u connect reverse eng/uConnext/src/main_swf/com/harman/moduleLinkAPI/IVersionInfo.as", "ActionScript", 27, 0, 0, 22, 49
"/home/michal-wyszynski/Desktop/u connect reverse eng/uConnext/src/main_swf/com/harman/moduleLinkAPI/IVicsDSRCEtcDiagHMI.as", "ActionScript", 16, 0, 0, 11, 27
"/home/michal-wyszynski/Desktop/u connect reverse eng/uConnext/src/main_swf/com/harman/moduleLinkAPI/IVicsDiagEngMenuHMI.as", "ActionScript", 10, 0, 0, 5, 15
"/home/michal-wyszynski/Desktop/u connect reverse eng/uConnext/src/main_swf/com/harman/moduleLinkAPI/IVicsEtcHMI.as", "ActionScript", 25, 0, 0, 20, 45
"/home/michal-wyszynski/Desktop/u connect reverse eng/uConnext/src/main_swf/com/harman/moduleLinkAPI/IVicsFMHMI.as", "ActionScript", 32, 0, 0, 27, 59
"/home/michal-wyszynski/Desktop/u connect reverse eng/uConnext/src/main_swf/com/harman/moduleLinkAPI/IVicsTunerHMI.as", "ActionScript", 29, 0, 0, 24, 53
"/home/michal-wyszynski/Desktop/u connect reverse eng/uConnext/src/main_swf/com/harman/moduleLinkAPI/IWiFiService.as", "ActionScript", 34, 0, 0, 29, 63
"/home/michal-wyszynski/Desktop/u connect reverse eng/uConnext/src/main_swf/com/harman/moduleLinkAPI/IiPodTagger.as", "ActionScript", 13, 0, 0, 8, 21
"/home/michal-wyszynski/Desktop/u connect reverse eng/uConnext/src/main_swf/com/harman/moduleLinkAPI/KanjiHMIEvent.as", "ActionScript", 15, 0, 0, 6, 21
"/home/michal-wyszynski/Desktop/u connect reverse eng/uConnext/src/main_swf/com/harman/moduleLinkAPI/LocationEvent.as", "ActionScript", 14, 0, 0, 5, 19
"/home/michal-wyszynski/Desktop/u connect reverse eng/uConnext/src/main_swf/com/harman/moduleLinkAPI/PPSEvent.as", "ActionScript", 14, 0, 0, 6, 20
"/home/michal-wyszynski/Desktop/u connect reverse eng/uConnext/src/main_swf/com/harman/moduleLinkAPI/PerformanceInfoEvent.as", "ActionScript", 14, 0, 0, 5, 19
"/home/michal-wyszynski/Desktop/u connect reverse eng/uConnext/src/main_swf/com/harman/moduleLinkAPI/PersistencyEvent.as", "ActionScript", 13, 0, 0, 4, 17
"/home/michal-wyszynski/Desktop/u connect reverse eng/uConnext/src/main_swf/com/harman/moduleLinkAPI/PersistencyKeys.as", "ActionScript", 19, 0, 0, 11, 30
"/home/michal-wyszynski/Desktop/u connect reverse eng/uConnext/src/main_swf/com/harman/moduleLinkAPI/ProductVariantID.as", "ActionScript", 34, 0, 0, 13, 47
"/home/michal-wyszynski/Desktop/u connect reverse eng/uConnext/src/main_swf/com/harman/moduleLinkAPI/RSEConstants.as", "ActionScript", 32, 0, 0, 24, 56
"/home/michal-wyszynski/Desktop/u connect reverse eng/uConnext/src/main_swf/com/harman/moduleLinkAPI/RseEvent.as", "ActionScript", 32, 0, 0, 23, 55
"/home/michal-wyszynski/Desktop/u connect reverse eng/uConnext/src/main_swf/com/harman/moduleLinkAPI/ServiceEvent.as", "ActionScript", 14, 0, 0, 5, 19
"/home/michal-wyszynski/Desktop/u connect reverse eng/uConnext/src/main_swf/com/harman/moduleLinkAPI/SierraUpdateEvent.as", "ActionScript", 15, 0, 0, 6, 21
"/home/michal-wyszynski/Desktop/u connect reverse eng/uConnext/src/main_swf/com/harman/moduleLinkAPI/SoftwareUpdateEvent.as", "ActionScript", 17, 0, 0, 8, 25
"/home/michal-wyszynski/Desktop/u connect reverse eng/uConnext/src/main_swf/com/harman/moduleLinkAPI/Time.as", "ActionScript", 20, 0, 0, 7, 27
"/home/michal-wyszynski/Desktop/u connect reverse eng/uConnext/src/main_swf/com/harman/moduleLinkAPI/TunerSeek.as", "ActionScript", 16, 0, 0, 8, 24
"/home/michal-wyszynski/Desktop/u connect reverse eng/uConnext/src/main_swf/com/harman/moduleLinkAPI/VehicleStatusEvent.as", "ActionScript", 22, 0, 0, 13, 35
"/home/michal-wyszynski/Desktop/u connect reverse eng/uConnext/src/main_swf/com/harman/moduleLinkAPI/VersionInfoEvent.as", "ActionScript", 18, 0, 0, 9, 27
"/home/michal-wyszynski/Desktop/u connect reverse eng/uConnext/src/main_swf/com/harman/moduleLinkAPI/VicsDSRCEtcDiagHMIEvent.as", "ActionScript", 19, 0, 0, 10, 29
"/home/michal-wyszynski/Desktop/u connect reverse eng/uConnext/src/main_swf/com/harman/moduleLinkAPI/VicsDiagEngMenuHMIEvent.as", "ActionScript", 15, 0, 0, 6, 21
"/home/michal-wyszynski/Desktop/u connect reverse eng/uConnext/src/main_swf/com/harman/moduleLinkAPI/VicsEtcHMIEvent.as", "ActionScript", 21, 0, 0, 12, 33
"/home/michal-wyszynski/Desktop/u connect reverse eng/uConnext/src/main_swf/com/harman/moduleLinkAPI/VicsEtcPaymentInfo.as", "ActionScript", 21, 0, 0, 13, 34
"/home/michal-wyszynski/Desktop/u connect reverse eng/uConnext/src/main_swf/com/harman/moduleLinkAPI/VicsFMHMIEvent.as", "ActionScript", 27, 0, 0, 18, 45
"/home/michal-wyszynski/Desktop/u connect reverse eng/uConnext/src/main_swf/com/harman/moduleLinkAPI/VicsFMInterButton.as", "ActionScript", 18, 0, 0, 5, 23
"/home/michal-wyszynski/Desktop/u connect reverse eng/uConnext/src/main_swf/com/harman/moduleLinkAPI/VicsFMMenuButton.as", "ActionScript", 32, 0, 0, 14, 46
"/home/michal-wyszynski/Desktop/u connect reverse eng/uConnext/src/main_swf/com/harman/moduleLinkAPI/VicsFMMenuDataState.as", "ActionScript", 21, 0, 0, 5, 26
"/home/michal-wyszynski/Desktop/u connect reverse eng/uConnext/src/main_swf/com/harman/moduleLinkAPI/VicsTunerHMIEvent.as", "ActionScript", 19, 0, 0, 10, 29
"/home/michal-wyszynski/Desktop/u connect reverse eng/uConnext/src/main_swf/com/harman/moduleLinkAPI/WiFiServiceEvent.as", "ActionScript", 36, 0, 0, 27, 63
"/home/michal-wyszynski/Desktop/u connect reverse eng/uConnext/src/main_swf/com/harman/moduleLinkAPI/vicsDiagEngMenuID.as", "ActionScript", 57, 0, 0, 17, 74
"/home/michal-wyszynski/Desktop/u connect reverse eng/uConnext/src/main_swf/com/nfuzion/geographic/Coordinates.as", "ActionScript", 160, 0, 0, 16, 176
"/home/michal-wyszynski/Desktop/u connect reverse eng/uConnext/src/main_swf/com/nfuzion/geographic/Direction.as", "ActionScript", 227, 0, 0, 11, 238
"/home/michal-wyszynski/Desktop/u connect reverse eng/uConnext/src/main_swf/com/nfuzion/geographic/Distance.as", "ActionScript", 40, 0, 0, 10, 50
"/home/michal-wyszynski/Desktop/u connect reverse eng/uConnext/src/main_swf/com/nfuzion/geographic/EarthModel.as", "ActionScript", 13, 0, 0, 5, 18
"/home/michal-wyszynski/Desktop/u connect reverse eng/uConnext/src/main_swf/com/nfuzion/moduleLink/AudioManager.as", "ActionScript", 768, 0, 0, 133, 901
"/home/michal-wyszynski/Desktop/u connect reverse eng/uConnext/src/main_swf/com/nfuzion/moduleLink/AudioSettings.as", "ActionScript", 839, 0, 0, 127, 966
"/home/michal-wyszynski/Desktop/u connect reverse eng/uConnext/src/main_swf/com/nfuzion/moduleLink/Bluetooth.as", "ActionScript", 1066, 0, 0, 98, 1164
"/home/michal-wyszynski/Desktop/u connect reverse eng/uConnext/src/main_swf/com/nfuzion/moduleLink/BluetoothHFP.as", "ActionScript", 999, 0, 0, 86, 1085
"/home/michal-wyszynski/Desktop/u connect reverse eng/uConnext/src/main_swf/com/nfuzion/moduleLink/BluetoothPhone.as", "ActionScript", 218, 0, 0, 49, 267
"/home/michal-wyszynski/Desktop/u connect reverse eng/uConnext/src/main_swf/com/nfuzion/moduleLink/Climate.as", "ActionScript", 206, 0, 0, 34, 240
"/home/michal-wyszynski/Desktop/u connect reverse eng/uConnext/src/main_swf/com/nfuzion/moduleLink/Clock.as", "ActionScript", 504, 0, 0, 63, 567
"/home/michal-wyszynski/Desktop/u connect reverse eng/uConnext/src/main_swf/com/nfuzion/moduleLink/Connection.as", "ActionScript", 90, 0, 0, 16, 106
"/home/michal-wyszynski/Desktop/u connect reverse eng/uConnext/src/main_swf/com/nfuzion/moduleLink/ConnectionEvent.as", "ActionScript", 107, 0, 0, 98, 205
"/home/michal-wyszynski/Desktop/u connect reverse eng/uConnext/src/main_swf/com/nfuzion/moduleLink/DMBManager.as", "ActionScript", 637, 0, 0, 94, 731
"/home/michal-wyszynski/Desktop/u connect reverse eng/uConnext/src/main_swf/com/nfuzion/moduleLink/DriveMode.as", "ActionScript", 2766, 0, 0, 290, 3056
"/home/michal-wyszynski/Desktop/u connect reverse eng/uConnext/src/main_swf/com/nfuzion/moduleLink/HdTuner.as", "ActionScript", 251, 0, 0, 46, 297
"/home/michal-wyszynski/Desktop/u connect reverse eng/uConnext/src/main_swf/com/nfuzion/moduleLink/HmiGatewayModule.as", "ActionScript", 68, 0, 0, 15, 83
"/home/michal-wyszynski/Desktop/u connect reverse eng/uConnext/src/main_swf/com/nfuzion/moduleLink/Hvac.as", "ActionScript", 1302, 0, 0, 200, 1502
"/home/michal-wyszynski/Desktop/u connect reverse eng/uConnext/src/main_swf/com/nfuzion/moduleLink/ICS.as", "ActionScript", 163, 0, 0, 23, 186
"/home/michal-wyszynski/Desktop/u connect reverse eng/uConnext/src/main_swf/com/nfuzion/moduleLink/MediaErrorCodes.as", "ActionScript", 43, 0, 0, 35, 78
"/home/michal-wyszynski/Desktop/u connect reverse eng/uConnext/src/main_swf/com/nfuzion/moduleLink/MediaPlayer.as", "ActionScript", 2296, 0, 0, 214, 2510
"/home/michal-wyszynski/Desktop/u connect reverse eng/uConnext/src/main_swf/com/nfuzion/moduleLink/PersonalConfig.as", "ActionScript", 2895, 0, 0, 477, 3372
"/home/michal-wyszynski/Desktop/u connect reverse eng/uConnext/src/main_swf/com/nfuzion/moduleLink/PhoneBook.as", "ActionScript", 960, 0, 0, 111, 1071
"/home/michal-wyszynski/Desktop/u connect reverse eng/uConnext/src/main_swf/com/nfuzion/moduleLink/PhoneCallList.as", "ActionScript", 389, 0, 0, 43, 432
"/home/michal-wyszynski/Desktop/u connect reverse eng/uConnext/src/main_swf/com/nfuzion/moduleLink/PresetPersistencyManager.as", "ActionScript", 604, 0, 0, 58, 662
"/home/michal-wyszynski/Desktop/u connect reverse eng/uConnext/src/main_swf/com/nfuzion/moduleLink/SMSMessaging.as", "ActionScript", 1082, 0, 0, 108, 1190
"/home/michal-wyszynski/Desktop/u connect reverse eng/uConnext/src/main_swf/com/nfuzion/moduleLink/SWC.as", "ActionScript", 156, 0, 0, 27, 183
"/home/michal-wyszynski/Desktop/u connect reverse eng/uConnext/src/main_swf/com/nfuzion/moduleLink/SatelliteRadio.as", "ActionScript", 2345, 0, 0, 284, 2629
"/home/michal-wyszynski/Desktop/u connect reverse eng/uConnext/src/main_swf/com/nfuzion/moduleLink/SatelliteRadioFullChannelList.as", "ActionScript", 329, 0, 0, 50, 379
"/home/michal-wyszynski/Desktop/u connect reverse eng/uConnext/src/main_swf/com/nfuzion/moduleLink/SatelliteRadioInstantReplay.as", "ActionScript", 332, 0, 0, 45, 377
"/home/michal-wyszynski/Desktop/u connect reverse eng/uConnext/src/main_swf/com/nfuzion/moduleLink/SpellerManager.as", "ActionScript", 156, 0, 0, 35, 191
"/home/michal-wyszynski/Desktop/u connect reverse eng/uConnext/src/main_swf/com/nfuzion/moduleLink/TextToSpeech.as", "ActionScript", 273, 0, 0, 43, 316
"/home/michal-wyszynski/Desktop/u connect reverse eng/uConnext/src/main_swf/com/nfuzion/moduleLink/TravelLink.as", "ActionScript", 115, 0, 0, 24, 139
"/home/michal-wyszynski/Desktop/u connect reverse eng/uConnext/src/main_swf/com/nfuzion/moduleLink/TravelLinkFuel.as", "ActionScript", 457, 0, 0, 50, 507
"/home/michal-wyszynski/Desktop/u connect reverse eng/uConnext/src/main_swf/com/nfuzion/moduleLink/TravelLinkLandWeather.as", "ActionScript", 1396, 0, 0, 100, 1496
"/home/michal-wyszynski/Desktop/u connect reverse eng/uConnext/src/main_swf/com/nfuzion/moduleLink/TravelLinkMovies.as", "ActionScript", 469, 0, 0, 84, 553
"/home/michal-wyszynski/Desktop/u connect reverse eng/uConnext/src/main_swf/com/nfuzion/moduleLink/TravelLinkSports.as", "ActionScript", 374, 0, 0, 67, 441
"/home/michal-wyszynski/Desktop/u connect reverse eng/uConnext/src/main_swf/com/nfuzion/moduleLink/Tuner.as", "ActionScript", 947, 0, 0, 163, 1110
"/home/michal-wyszynski/Desktop/u connect reverse eng/uConnext/src/main_swf/com/nfuzion/moduleLink/VehConfig.as", "ActionScript", 1624, 0, 0, 405, 2029
"/home/michal-wyszynski/Desktop/u connect reverse eng/uConnext/src/main_swf/com/nfuzion/moduleLink/VehSettings.as", "ActionScript", 868, 0, 0, 125, 993
"/home/michal-wyszynski/Desktop/u connect reverse eng/uConnext/src/main_swf/com/nfuzion/moduleLink/VoiceRecState.as", "ActionScript", 46, 0, 0, 7, 53
"/home/michal-wyszynski/Desktop/u connect reverse eng/uConnext/src/main_swf/com/nfuzion/moduleLink/VoiceRecognition.as", "ActionScript", 1515, 0, 0, 339, 1854
"/home/michal-wyszynski/Desktop/u connect reverse eng/uConnext/src/main_swf/com/nfuzion/moduleLinkAPI/AlphaJumpIndex.as", "ActionScript", 12, 0, 0, 4, 16
"/home/michal-wyszynski/Desktop/u connect reverse eng/uConnext/src/main_swf/com/nfuzion/moduleLinkAPI/AnalogStationInfo.as", "ActionScript", 39, 0, 0, 11, 50
"/home/michal-wyszynski/Desktop/u connect reverse eng/uConnext/src/main_swf/com/nfuzion/moduleLinkAPI/AudioEvent.as", "ActionScript", 29, 0, 0, 21, 50
"/home/michal-wyszynski/Desktop/u connect reverse eng/uConnext/src/main_swf/com/nfuzion/moduleLinkAPI/BluetoothCall.as", "ActionScript", 99, 0, 0, 32, 131
"/home/michal-wyszynski/Desktop/u connect reverse eng/uConnext/src/main_swf/com/nfuzion/moduleLinkAPI/BluetoothConnectionHistory.as", "ActionScript", 46, 0, 0, 14, 60
"/home/michal-wyszynski/Desktop/u connect reverse eng/uConnext/src/main_swf/com/nfuzion/moduleLinkAPI/BluetoothDevice.as", "ActionScript", 270, 0, 0, 66, 336
"/home/michal-wyszynski/Desktop/u connect reverse eng/uConnext/src/main_swf/com/nfuzion/moduleLinkAPI/BluetoothEvent.as", "ActionScript", 108, 0, 0, 93, 201
"/home/michal-wyszynski/Desktop/u connect reverse eng/uConnext/src/main_swf/com/nfuzion/moduleLinkAPI/BluetoothNetworkOperator.as", "ActionScript", 55, 0, 0, 17, 72
"/home/michal-wyszynski/Desktop/u connect reverse eng/uConnext/src/main_swf/com/nfuzion/moduleLinkAPI/BluetoothProfile.as", "ActionScript", 37, 0, 0, 11, 48
"/home/michal-wyszynski/Desktop/u connect reverse eng/uConnext/src/main_swf/com/nfuzion/moduleLinkAPI/BluetoothPropertyConstants.as", "ActionScript", 16, 0, 0, 8, 24
"/home/michal-wyszynski/Desktop/u connect reverse eng/uConnext/src/main_swf/com/nfuzion/moduleLinkAPI/ClimateEvent.as", "ActionScript", 16, 0, 0, 7, 23
"/home/michal-wyszynski/Desktop/u connect reverse eng/uConnext/src/main_swf/com/nfuzion/moduleLinkAPI/ClockEvent.as", "ActionScript", 20, 0, 0, 12, 32
"/home/michal-wyszynski/Desktop/u connect reverse eng/uConnext/src/main_swf/com/nfuzion/moduleLinkAPI/DMBAppEvent.as", "ActionScript", 40, 0, 0, 28, 68
"/home/michal-wyszynski/Desktop/u connect reverse eng/uConnext/src/main_swf/com/nfuzion/moduleLinkAPI/DataServicesState.as", "ActionScript", 12, 0, 0, 4, 16
"/home/michal-wyszynski/Desktop/u connect reverse eng/uConnext/src/main_swf/com/nfuzion/moduleLinkAPI/DataServicesSubscriptionStatus.as", "ActionScript", 21, 0, 0, 13, 34
"/home/michal-wyszynski/Desktop/u connect reverse eng/uConnext/src/main_swf/com/nfuzion/moduleLinkAPI/DataStatus.as", "ActionScript", 13, 0, 0, 5, 18
"/home/michal-wyszynski/Desktop/u connect reverse eng/uConnext/src/main_swf/com/nfuzion/moduleLinkAPI/DriveModeEvent.as", "ActionScript", 66, 0, 0, 57, 123
"/home/michal-wyszynski/Desktop/u connect reverse eng/uConnext/src/main_swf/com/nfuzion/moduleLinkAPI/DriveModeSetOption.as", "ActionScript", 74, 0, 0, 66, 140
"/home/michal-wyszynski/Desktop/u connect reverse eng/uConnext/src/main_swf/com/nfuzion/moduleLinkAPI/FuelPrice.as", "ActionScript", 14, 0, 0, 6, 20
"/home/michal-wyszynski/Desktop/u connect reverse eng/uConnext/src/main_swf/com/nfuzion/moduleLinkAPI/FuelStation.as", "ActionScript", 28, 0, 0, 18, 46
"/home/michal-wyszynski/Desktop/u connect reverse eng/uConnext/src/main_swf/com/nfuzion/moduleLinkAPI/FuelStationList.as", "ActionScript", 22, 0, 0, 6, 28
"/home/michal-wyszynski/Desktop/u connect reverse eng/uConnext/src/main_swf/com/nfuzion/moduleLinkAPI/FuelStationSortField.as", "ActionScript", 13, 0, 0, 5, 18
"/home/michal-wyszynski/Desktop/u connect reverse eng/uConnext/src/main_swf/com/nfuzion/moduleLinkAPI/GameAlert.as", "ActionScript", 109, 0, 0, 35, 144
"/home/michal-wyszynski/Desktop/u connect reverse eng/uConnext/src/main_swf/com/nfuzion/moduleLinkAPI/GameZoneFavoriteTeam.as", "ActionScript", 61, 0, 0, 23, 84
"/home/michal-wyszynski/Desktop/u connect reverse eng/uConnext/src/main_swf/com/nfuzion/moduleLinkAPI/GameZoneLeagues.as", "ActionScript", 17, 0, 0, 6, 23
"/home/michal-wyszynski/Desktop/u connect reverse eng/uConnext/src/main_swf/com/nfuzion/moduleLinkAPI/GameZoneScoreAlert.as", "ActionScript", 37, 0, 0, 11, 48
"/home/michal-wyszynski/Desktop/u connect reverse eng/uConnext/src/main_swf/com/nfuzion/moduleLinkAPI/HdStationInfo.as", "ActionScript", 59, 0, 0, 13, 72
"/home/michal-wyszynski/Desktop/u connect reverse eng/uConnext/src/main_swf/com/nfuzion/moduleLinkAPI/HdStatus.as", "ActionScript", 95, 0, 0, 21, 116
"/home/michal-wyszynski/Desktop/u connect reverse eng/uConnext/src/main_swf/com/nfuzion/moduleLinkAPI/HdTunerEvent.as", "ActionScript", 20, 0, 0, 11, 31
"/home/michal-wyszynski/Desktop/u connect reverse eng/uConnext/src/main_swf/com/nfuzion/moduleLinkAPI/HvacEvent.as", "ActionScript", 26, 0, 0, 18, 44
"/home/michal-wyszynski/Desktop/u connect reverse eng/uConnext/src/main_swf/com/nfuzion/moduleLinkAPI/IAudioManager.as", "ActionScript", 68, 0, 0, 63, 131
"/home/michal-wyszynski/Desktop/u connect reverse eng/uConnext/src/main_swf/com/nfuzion/moduleLinkAPI/IAudioSettings.as", "ActionScript", 50, 0, 0, 45, 95
"/home/michal-wyszynski/Desktop/u connect reverse eng/uConnext/src/main_swf/com/nfuzion/moduleLinkAPI/IBluetooth.as", "ActionScript", 43, 0, 0, 38, 81
"/home/michal-wyszynski/Desktop/u connect reverse eng/uConnext/src/main_swf/com/nfuzion/moduleLinkAPI/IBluetoothHFP.as", "ActionScript", 57, 0, 0, 52, 109
"/home/michal-wyszynski/Desktop/u connect reverse eng/uConnext/src/main_swf/com/nfuzion/moduleLinkAPI/IBluetoothPhone.as", "ActionScript", 44, 0, 0, 39, 83
"/home/michal-wyszynski/Desktop/u connect reverse eng/uConnext/src/main_swf/com/nfuzion/moduleLinkAPI/ICSEvent.as", "ActionScript", 31, 0, 0, 22, 53
"/home/michal-wyszynski/Desktop/u connect reverse eng/uConnext/src/main_swf/com/nfuzion/moduleLinkAPI/IClimate.as", "ActionScript", 10, 0, 0, 5, 15
"/home/michal-wyszynski/Desktop/u connect reverse eng/uConnext/src/main_swf/com/nfuzion/moduleLinkAPI/IClock.as", "ActionScript", 32, 0, 0, 27, 59
"/home/michal-wyszynski/Desktop/u connect reverse eng/uConnext/src/main_swf/com/nfuzion/moduleLinkAPI/IDMBManager.as", "ActionScript", 16, 0, 0, 11, 27
"/home/michal-wyszynski/Desktop/u connect reverse eng/uConnext/src/main_swf/com/nfuzion/moduleLinkAPI/IDriveMode.as", "ActionScript", 111, 0, 0, 106, 217
"/home/michal-wyszynski/Desktop/u connect reverse eng/uConnext/src/main_swf/com/nfuzion/moduleLinkAPI/IHdTuner.as", "ActionScript", 34, 0, 0, 29, 63
"/home/michal-wyszynski/Desktop/u connect reverse eng/uConnext/src/main_swf/com/nfuzion/moduleLinkAPI/IHvac.as", "ActionScript", 87, 0, 0, 82, 169
"/home/michal-wyszynski/Desktop/u connect reverse eng/uConnext/src/main_swf/com/nfuzion/moduleLinkAPI/IICS.as", "ActionScript", 9, 0, 0, 4, 13
"/home/michal-wyszynski/Desktop/u connect reverse eng/uConnext/src/main_swf/com/nfuzion/moduleLinkAPI/IMediaPlayer.as", "ActionScript", 85, 0, 0, 80, 165
"/home/michal-wyszynski/Desktop/u connect reverse eng/uConnext/src/main_swf/com/nfuzion/moduleLinkAPI/IModule.as", "ActionScript", 15, 0, 0, 10, 25
"/home/michal-wyszynski/Desktop/u connect reverse eng/uConnext/src/main_swf/com/nfuzion/moduleLinkAPI/IPersonalConfig.as", "ActionScript", 264, 0, 0, 259, 523
"/home/michal-wyszynski/Desktop/u connect reverse eng/uConnext/src/main_swf/com/nfuzion/moduleLinkAPI/IPhoneBook.as", "ActionScript", 46, 0, 0, 41, 87
"/home/michal-wyszynski/Desktop/u connect reverse eng/uConnext/src/main_swf/com/nfuzion/moduleLinkAPI/IPhoneCallList.as", "ActionScript", 17, 0, 0, 12, 29
"/home/michal-wyszynski/Desktop/u connect reverse eng/uConnext/src/main_swf/com/nfuzion/moduleLinkAPI/IPresetPersistencyManager.as", "ActionScript", 10, 0, 0, 5, 15
"/home/michal-wyszynski/Desktop/u connect reverse eng/uConnext/src/main_swf/com/nfuzion/moduleLinkAPI/ISMSMessaging.as", "ActionScript", 44, 0, 0, 39, 83
"/home/michal-wyszynski/Desktop/u connect reverse eng/uConnext/src/main_swf/com/nfuzion/moduleLinkAPI/ISWC.as", "ActionScript", 6, 0, 0, 3, 9
"/home/michal-wyszynski/Desktop/u connect reverse eng/uConnext/src/main_swf/com/nfuzion/moduleLinkAPI/ISWCEvent.as", "ActionScript", 25, 0, 0, 13, 38
"/home/michal-wyszynski/Desktop/u connect reverse eng/uConnext/src/main_swf/com/nfuzion/moduleLinkAPI/ISatelliteRadio.as", "ActionScript", 119, 0, 0, 114, 233
"/home/michal-wyszynski/Desktop/u connect reverse eng/uConnext/src/main_swf/com/nfuzion/moduleLinkAPI/ISatelliteRadioInstantReplay.as", "ActionScript", 26, 0, 0, 21, 47
"/home/michal-wyszynski/Desktop/u connect reverse eng/uConnext/src/main_swf/com/nfuzion/moduleLinkAPI/ISpellerManager.as", "ActionScript", 15, 0, 0, 10, 25
"/home/michal-wyszynski/Desktop/u connect reverse eng/uConnext/src/main_swf/com/nfuzion/moduleLinkAPI/ITextToSpeech.as", "ActionScript", 18, 0, 0, 13, 31
"/home/michal-wyszynski/Desktop/u connect reverse eng/uConnext/src/main_swf/com/nfuzion/moduleLinkAPI/ITravelLink.as", "ActionScript", 19, 0, 0, 14, 33
"/home/michal-wyszynski/Desktop/u connect reverse eng/uConnext/src/main_swf/com/nfuzion/moduleLinkAPI/ITravelLinkFuel.as", "ActionScript", 33, 0, 0, 27, 60
"/home/michal-wyszynski/Desktop/u connect reverse eng/uConnext/src/main_swf/com/nfuzion/moduleLinkAPI/ITravelLinkLandWeather.as", "ActionScript", 58, 0, 0, 53, 111
"/home/michal-wyszynski/Desktop/u connect reverse eng/uConnext/src/main_swf/com/nfuzion/moduleLinkAPI/ITravelLinkMovies.as", "ActionScript", 33, 0, 0, 27, 60
"/home/michal-wyszynski/Desktop/u connect reverse eng/uConnext/src/main_swf/com/nfuzion/moduleLinkAPI/ITravelLinkSports.as", "ActionScript", 28, 0, 0, 23, 51
"/home/michal-wyszynski/Desktop/u connect reverse eng/uConnext/src/main_swf/com/nfuzion/moduleLinkAPI/ITuner.as", "ActionScript", 81, 0, 0, 76, 157
"/home/michal-wyszynski/Desktop/u connect reverse eng/uConnext/src/main_swf/com/nfuzion/moduleLinkAPI/IVehConfig.as", "ActionScript", 134, 0, 0, 129, 263
"/home/michal-wyszynski/Desktop/u connect reverse eng/uConnext/src/main_swf/com/nfuzion/moduleLinkAPI/IVehSettings.as", "ActionScript", 52, 0, 0, 47, 99
"/home/michal-wyszynski/Desktop/u connect reverse eng/uConnext/src/main_swf/com/nfuzion/moduleLinkAPI/IVoiceRecognition.as", "ActionScript", 144, 0, 0, 139, 283
"/home/michal-wyszynski/Desktop/u connect reverse eng/uConnext/src/main_swf/com/nfuzion/moduleLinkAPI/MarketConverter.as", "ActionScript", 78, 0, 0, 4, 82
"/home/michal-wyszynski/Desktop/u connect reverse eng/uConnext/src/main_swf/com/nfuzion/moduleLinkAPI/MediaPlayerDevice.as", "ActionScript", 23, 0, 0, 15, 38
"/home/michal-wyszynski/Desktop/u connect reverse eng/uConnext/src/main_swf/com/nfuzion/moduleLinkAPI/MediaPlayerEvent.as", "ActionScript", 40, 0, 0, 31, 71
"/home/michal-wyszynski/Desktop/u connect reverse eng/uConnext/src/main_swf/com/nfuzion/moduleLinkAPI/MediaPlayerItem.as", "ActionScript", 33, 0, 0, 22, 55
"/home/michal-wyszynski/Desktop/u connect reverse eng/uConnext/src/main_swf/com/nfuzion/moduleLinkAPI/MediaPlayerItemList.as", "ActionScript", 31, 0, 0, 7, 38
"/home/michal-wyszynski/Desktop/u connect reverse eng/uConnext/src/main_swf/com/nfuzion/moduleLinkAPI/MediaPlayerPath.as", "ActionScript", 39, 0, 0, 28, 67
"/home/michal-wyszynski/Desktop/u connect reverse eng/uConnext/src/main_swf/com/nfuzion/moduleLinkAPI/MediaPlayerRandomMode.as", "ActionScript", 14, 0, 0, 6, 20
"/home/michal-wyszynski/Desktop/u connect reverse eng/uConnext/src/main_swf/com/nfuzion/moduleLinkAPI/MediaPlayerRepeatMode.as", "ActionScript", 14, 0, 0, 6, 20
"/home/michal-wyszynski/Desktop/u connect reverse eng/uConnext/src/main_swf/com/nfuzion/moduleLinkAPI/MediaPlayerSyncState.as", "ActionScript", 14, 0, 0, 6, 20
"/home/michal-wyszynski/Desktop/u connect reverse eng/uConnext/src/main_swf/com/nfuzion/moduleLinkAPI/MediaPlayerTrackInfo.as", "ActionScript", 21, 0, 0, 13, 34
"/home/michal-wyszynski/Desktop/u connect reverse eng/uConnext/src/main_swf/com/nfuzion/moduleLinkAPI/MediaPlayerTransportAction.as", "ActionScript", 22, 0, 0, 14, 36
"/home/michal-wyszynski/Desktop/u connect reverse eng/uConnext/src/main_swf/com/nfuzion/moduleLinkAPI/Module.as", "ActionScript", 97, 0, 0, 16, 113
"/home/michal-wyszynski/Desktop/u connect reverse eng/uConnext/src/main_swf/com/nfuzion/moduleLinkAPI/ModuleEvent.as", "ActionScript", 16, 0, 0, 4, 20
"/home/michal-wyszynski/Desktop/u connect reverse eng/uConnext/src/main_swf/com/nfuzion/moduleLinkAPI/PersonalConfigEvent.as", "ActionScript", 100, 0, 0, 91, 191
"/home/michal-wyszynski/Desktop/u connect reverse eng/uConnext/src/main_swf/com/nfuzion/moduleLinkAPI/PhoneBookContact.as", "ActionScript", 92, 0, 0, 13, 105
"/home/michal-wyszynski/Desktop/u connect reverse eng/uConnext/src/main_swf/com/nfuzion/moduleLinkAPI/PhoneBookEvent.as", "ActionScript", 26, 0, 0, 17, 43
"/home/michal-wyszynski/Desktop/u connect reverse eng/uConnext/src/main_swf/com/nfuzion/moduleLinkAPI/PhoneCallListEntry.as", "ActionScript", 93, 0, 0, 21, 114
"/home/michal-wyszynski/Desktop/u connect reverse eng/uConnext/src/main_swf/com/nfuzion/moduleLinkAPI/PhoneCallListEvent.as", "ActionScript", 22, 0, 0, 13, 35
"/home/michal-wyszynski/Desktop/u connect reverse eng/uConnext/src/main_swf/com/nfuzion/moduleLinkAPI/Preset.as", "ActionScript", 154, 0, 0, 33, 187
"/home/michal-wyszynski/Desktop/u connect reverse eng/uConnext/src/main_swf/com/nfuzion/moduleLinkAPI/PresetPersistencyConstants.as", "ActionScript", 14, 0, 0, 6, 20
"/home/michal-wyszynski/Desktop/u connect reverse eng/uConnext/src/main_swf/com/nfuzion/moduleLinkAPI/PresetPersistencyManagerEvent.as", "ActionScript", 16, 0, 0, 7, 23
"/home/michal-wyszynski/Desktop/u connect reverse eng/uConnext/src/main_swf/com/nfuzion/moduleLinkAPI/SMSMessage.as", "ActionScript", 17, 0, 0, 9, 26
"/home/michal-wyszynski/Desktop/u connect reverse eng/uConnext/src/main_swf/com/nfuzion/moduleLinkAPI/SMSMessageEvent.as", "ActionScript", 41, 0, 0, 23, 64
"/home/michal-wyszynski/Desktop/u connect reverse eng/uConnext/src/main_swf/com/nfuzion/moduleLinkAPI/SatelliteRadioActiveFavorite.as", "ActionScript", 13, 0, 0, 5, 18
"/home/michal-wyszynski/Desktop/u connect reverse eng/uConnext/src/main_swf/com/nfuzion/moduleLinkAPI/SatelliteRadioCategory.as", "ActionScript", 15, 0, 0, 7, 22
"/home/michal-wyszynski/Desktop/u connect reverse eng/uConnext/src/main_swf/com/nfuzion/moduleLinkAPI/SatelliteRadioCategoryList.as", "ActionScript", 26, 0, 0, 7, 33
"/home/michal-wyszynski/Desktop/u connect reverse eng/uConnext/src/main_swf/com/nfuzion/moduleLinkAPI/SatelliteRadioChannel.as", "ActionScript", 57, 0, 0, 30, 87
"/home/michal-wyszynski/Desktop/u connect reverse eng/uConnext/src/main_swf/com/nfuzion/moduleLinkAPI/SatelliteRadioChannelList.as", "ActionScript", 129, 0, 0, 21, 150
"/home/michal-wyszynski/Desktop/u connect reverse eng/uConnext/src/main_swf/com/nfuzion/moduleLinkAPI/SatelliteRadioEvent.as", "ActionScript", 62, 0, 0, 44, 106
"/home/michal-wyszynski/Desktop/u connect reverse eng/uConnext/src/main_swf/com/nfuzion/moduleLinkAPI/SatelliteRadioFavorite.as", "ActionScript", 19, 0, 0, 11, 30
"/home/michal-wyszynski/Desktop/u connect reverse eng/uConnext/src/main_swf/com/nfuzion/moduleLinkAPI/SatelliteRadioFeaturedFavorite.as", "ActionScript", 28, 0, 0, 7, 35
"/home/michal-wyszynski/Desktop/u connect reverse eng/uConnext/src/main_swf/com/nfuzion/moduleLinkAPI/SatelliteRadioFeaturedFavoriteBand.as", "ActionScript", 46, 0, 0, 13, 59
"/home/michal-wyszynski/Desktop/u connect reverse eng/uConnext/src/main_swf/com/nfuzion/moduleLinkAPI/SatelliteRadioInstantReplayBufferEntry.as", "ActionScript", 64, 0, 0, 20, 84
"/home/michal-wyszynski/Desktop/u connect reverse eng/uConnext/src/main_swf/com/nfuzion/moduleLinkAPI/SatelliteRadioInstantReplayBufferInfo.as", "ActionScript", 55, 0, 0, 17, 72
"/home/michal-wyszynski/Desktop/u connect reverse eng/uConnext/src/main_swf/com/nfuzion/moduleLinkAPI/SatelliteRadioInstantReplayEvent.as", "ActionScript", 21, 0, 0, 12, 33
"/home/michal-wyszynski/Desktop/u connect reverse eng/uConnext/src/main_swf/com/nfuzion/moduleLinkAPI/SatelliteRadioInstantReplayPlayStatus.as", "ActionScript", 55, 0, 0, 17, 72
"/home/michal-wyszynski/Desktop/u connect reverse eng/uConnext/src/main_swf/com/nfuzion/moduleLinkAPI/SatelliteRadioPreset.as", "ActionScript", 12, 0, 0, 4, 16
"/home/michal-wyszynski/Desktop/u connect reverse eng/uConnext/src/main_swf/com/nfuzion/moduleLinkAPI/SatelliteRadioTrafficChannel.as", "ActionScript", 12, 0, 0, 3, 15
"/home/michal-wyszynski/Desktop/u connect reverse eng/uConnext/src/main_swf/com/nfuzion/moduleLinkAPI/SignalStats.as", "ActionScript", 12, 0, 0, 4, 16
"/home/michal-wyszynski/Desktop/u connect reverse eng/uConnext/src/main_swf/com/nfuzion/moduleLinkAPI/SpellerEvent.as", "ActionScript", 24, 0, 0, 12, 36
"/home/michal-wyszynski/Desktop/u connect reverse eng/uConnext/src/main_swf/com/nfuzion/moduleLinkAPI/TextToSpeechEvent.as", "ActionScript", 23, 0, 0, 8, 31
"/home/michal-wyszynski/Desktop/u connect reverse eng/uConnext/src/main_swf/com/nfuzion/moduleLinkAPI/TravelLinkFuelEvent.as", "ActionScript", 27, 0, 0, 15, 42
"/home/michal-wyszynski/Desktop/u connect reverse eng/uConnext/src/main_swf/com/nfuzion/moduleLinkAPI/TravelLinkLandWeatherEvent.as", "ActionScript", 35, 0, 0, 26, 61
"/home/michal-wyszynski/Desktop/u connect reverse eng/uConnext/src/main_swf/com/nfuzion/moduleLinkAPI/TravelLinkMoviesEvent.as", "ActionScript", 23, 0, 0, 14, 37
"/home/michal-wyszynski/Desktop/u connect reverse eng/uConnext/src/main_swf/com/nfuzion/moduleLinkAPI/TravelLinkMoviesMovie.as", "ActionScript", 30, 0, 0, 6, 36
"/home/michal-wyszynski/Desktop/u connect reverse eng/uConnext/src/main_swf/com/nfuzion/moduleLinkAPI/TravelLinkMoviesMovieDetails.as", "ActionScript", 45, 0, 0, 9, 54
"/home/michal-wyszynski/Desktop/u connect reverse eng/uConnext/src/main_swf/com/nfuzion/moduleLinkAPI/TravelLinkMoviesMovieList.as", "ActionScript", 116, 0, 0, 12, 128
"/home/michal-wyszynski/Desktop/u connect reverse eng/uConnext/src/main_swf/com/nfuzion/moduleLinkAPI/TravelLinkMoviesMovieListing.as", "ActionScript", 105, 0, 0, 15, 120
"/home/michal-wyszynski/Desktop/u connect reverse eng/uConnext/src/main_swf/com/nfuzion/moduleLinkAPI/TravelLinkMoviesShowTimes.as", "ActionScript", 51, 0, 0, 9, 60
"/home/michal-wyszynski/Desktop/u connect reverse eng/uConnext/src/main_swf/com/nfuzion/moduleLinkAPI/TravelLinkMoviesTheater.as", "ActionScript", 91, 0, 0, 12, 103
"/home/michal-wyszynski/Desktop/u connect reverse eng/uConnext/src/main_swf/com/nfuzion/moduleLinkAPI/TravelLinkMoviesTheaterDetails.as", "ActionScript", 66, 0, 0, 14, 80
"/home/michal-wyszynski/Desktop/u connect reverse eng/uConnext/src/main_swf/com/nfuzion/moduleLinkAPI/TravelLinkMoviesTheaterList.as", "ActionScript", 141, 0, 0, 18, 159
"/home/michal-wyszynski/Desktop/u connect reverse eng/uConnext/src/main_swf/com/nfuzion/moduleLinkAPI/TravelLinkSportsEvent.as", "ActionScript", 29, 0, 0, 17, 46
"/home/michal-wyszynski/Desktop/u connect reverse eng/uConnext/src/main_swf/com/nfuzion/moduleLinkAPI/TravelLinkSportsGameList.as", "ActionScript", 162, 0, 0, 34, 196
"/home/michal-wyszynski/Desktop/u connect reverse eng/uConnext/src/main_swf/com/nfuzion/moduleLinkAPI/TravelLinkSportsGameListItem.as", "ActionScript", 67, 0, 0, 20, 87
"/home/michal-wyszynski/Desktop/u connect reverse eng/uConnext/src/main_swf/com/nfuzion/moduleLinkAPI/TravelLinkSportsGenericList.as", "ActionScript", 245, 0, 0, 54, 299
"/home/michal-wyszynski/Desktop/u connect reverse eng/uConnext/src/main_swf/com/nfuzion/moduleLinkAPI/TravelLinkSportsGenericListItem.as", "ActionScript", 156, 0, 0, 49, 205
"/home/michal-wyszynski/Desktop/u connect reverse eng/uConnext/src/main_swf/com/nfuzion/moduleLinkAPI/TravelLinkSportsNewsItem.as", "ActionScript", 53, 0, 0, 14, 67
"/home/michal-wyszynski/Desktop/u connect reverse eng/uConnext/src/main_swf/com/nfuzion/moduleLinkAPI/TravelLinkSportsScreenTypes.as", "ActionScript", 20, 0, 0, 12, 32
"/home/michal-wyszynski/Desktop/u connect reverse eng/uConnext/src/main_swf/com/nfuzion/moduleLinkAPI/TravelLinkSportsTable.as", "ActionScript", 141, 0, 0, 26, 167
"/home/michal-wyszynski/Desktop/u connect reverse eng/uConnext/src/main_swf/com/nfuzion/moduleLinkAPI/TravelLinkStatus.as", "ActionScript", 13, 0, 0, 5, 18
"/home/michal-wyszynski/Desktop/u connect reverse eng/uConnext/src/main_swf/com/nfuzion/moduleLinkAPI/TunerBand.as", "ActionScript", 19, 0, 0, 11, 30
"/home/michal-wyszynski/Desktop/u connect reverse eng/uConnext/src/main_swf/com/nfuzion/moduleLinkAPI/TunerDiagACFInfo.as", "ActionScript", 50, 0, 0, 11, 61
"/home/michal-wyszynski/Desktop/u connect reverse eng/uConnext/src/main_swf/com/nfuzion/moduleLinkAPI/TunerDiagFieldStrength.as", "ActionScript", 29, 0, 0, 6, 35
"/home/michal-wyszynski/Desktop/u connect reverse eng/uConnext/src/main_swf/com/nfuzion/moduleLinkAPI/TunerDiagFuncInfo.as", "ActionScript", 83, 0, 0, 15, 98
"/home/michal-wyszynski/Desktop/u connect reverse eng/uConnext/src/main_swf/com/nfuzion/moduleLinkAPI/TunerDiagPartInfo.as", "ActionScript", 102, 0, 0, 19, 121
"/home/michal-wyszynski/Desktop/u connect reverse eng/uConnext/src/main_swf/com/nfuzion/moduleLinkAPI/TunerDiagRDS.as", "ActionScript", 98, 0, 0, 18, 116
"/home/michal-wyszynski/Desktop/u connect reverse eng/uConnext/src/main_swf/com/nfuzion/moduleLinkAPI/TunerDiagRSQInfo.as", "ActionScript", 89, 0, 0, 18, 107
"/home/michal-wyszynski/Desktop/u connect reverse eng/uConnext/src/main_swf/com/nfuzion/moduleLinkAPI/TunerEvent.as", "ActionScript", 36, 0, 0, 27, 63
"/home/michal-wyszynski/Desktop/u connect reverse eng/uConnext/src/main_swf/com/nfuzion/moduleLinkAPI/TunerRegion.as", "ActionScript", 19, 0, 0, 11, 30
"/home/michal-wyszynski/Desktop/u connect reverse eng/uConnext/src/main_swf/com/nfuzion/moduleLinkAPI/VehConfigEvent.as", "ActionScript", 14, 0, 0, 6, 20
"/home/michal-wyszynski/Desktop/u connect reverse eng/uConnext/src/main_swf/com/nfuzion/moduleLinkAPI/VehSettingsEvent.as", "ActionScript", 26, 0, 0, 18, 44
"/home/michal-wyszynski/Desktop/u connect reverse eng/uConnext/src/main_swf/com/nfuzion/moduleLinkAPI/VoiceRecognitionEvent.as", "ActionScript", 42, 0, 0, 33, 75
"/home/michal-wyszynski/Desktop/u connect reverse eng/uConnext/src/main_swf/com/nfuzion/moduleLinkAPI/WeatherCondition.as", "ActionScript", 23, 0, 0, 15, 38
"/home/michal-wyszynski/Desktop/u connect reverse eng/uConnext/src/main_swf/com/nfuzion/moduleLinkAPI/WeatherDetail.as", "ActionScript", 12, 0, 0, 4, 16
"/home/michal-wyszynski/Desktop/u connect reverse eng/uConnext/src/main_swf/com/nfuzion/moduleLinkAPI/WeatherForecastDay.as", "ActionScript", 17, 0, 0, 9, 26
"/home/michal-wyszynski/Desktop/u connect reverse eng/uConnext/src/main_swf/com/nfuzion/moduleLinkAPI/WeatherForecastHour.as", "ActionScript", 15, 0, 0, 7, 22
"/home/michal-wyszynski/Desktop/u connect reverse eng/uConnext/src/main_swf/com/nfuzion/moduleLinkAPI/WeatherLocation.as", "ActionScript", 13, 0, 0, 5, 18
"/home/michal-wyszynski/Desktop/u connect reverse eng/uConnext/src/main_swf/com/nfuzion/moduleLinkAPI/WeatherSelectionMode.as", "ActionScript", 13, 0, 0, 5, 18
"/home/michal-wyszynski/Desktop/u connect reverse eng/uConnext/src/main_swf/com/nfuzion/span/Client.as", "ActionScript", 113, 0, 0, 23, 136
"/home/michal-wyszynski/Desktop/u connect reverse eng/uConnext/src/main_swf/com/uconnext/Core.as", "ActionScript", 384, 0, 5, 44, 433
"/home/michal-wyszynski/Desktop/u connect reverse eng/uConnext/src/main_swf/com/uconnext/DeviceConfig.as", "ActionScript", 14, 0, 0, 4, 18
"/home/michal-wyszynski/Desktop/u connect reverse eng/uConnext/src/main_swf/com/uconnext/Log.as", "ActionScript", 44, 0, 4, 9, 57
"/home/michal-wyszynski/Desktop/u connect reverse eng/uConnext/src/main_swf/com/uconnext/PeripheralLoader.as", "ActionScript", 34, 0, 1, 1, 36
"/home/michal-wyszynski/Desktop/u connect reverse eng/uConnext/src/main_swf/com/uconnext/SpeedLockout.as", "ActionScript", 238, 0, 0, 4, 242
"/home/michal-wyszynski/Desktop/u connect reverse eng/uConnext/src/main_swf/com/uconnext/SystemUIEvent.as", "ActionScript", 7, 0, 0, 0, 7
"/home/michal-wyszynski/Desktop/u connect reverse eng/uConnext/src/main_swf/com/uconnext/api/v1/Audio.as", "ActionScript", 497, 0, 11, 112, 620
"/home/michal-wyszynski/Desktop/u connect reverse eng/uConnext/src/main_swf/com/uconnext/api/v1/GlobalVars.as", "ActionScript", 22, 0, 5, 21, 48
"/home/michal-wyszynski/Desktop/u connect reverse eng/uConnext/src/main_swf/com/uconnext/api/v1/Vehicle.as", "ActionScript", 69, 0, 9, 14, 92
"/home/michal-wyszynski/Desktop/u connect reverse eng/uConnext/src/main_swf/events/EmergencyCallStateEvent.as", "ActionScript", 29, 0, 0, 15, 44
"/home/michal-wyszynski/Desktop/u connect reverse eng/uConnext/src/main_swf/events/FrameworkEvent.as", "ActionScript", 22, 0, 0, 8, 30
"/home/michal-wyszynski/Desktop/u connect reverse eng/uConnext/src/main_swf/events/GlobalEvent.as", "ActionScript", 50, 0, 0, 35, 85
"/home/michal-wyszynski/Desktop/u connect reverse eng/uConnext/src/main_swf/events/HardControlEvent.as", "ActionScript", 29, 0, 0, 14, 43
"/home/michal-wyszynski/Desktop/u connect reverse eng/uConnext/src/main_swf/events/LocaleEvent.as", "ActionScript", 12, 0, 0, 4, 16
"/home/michal-wyszynski/Desktop/u connect reverse eng/uConnext/src/main_swf/events/PresetManagerEvent.as", "ActionScript", 22, 0, 0, 7, 29
"/home/michal-wyszynski/Desktop/u connect reverse eng/uConnext/src/main_swf/events/SoundEvent.as", "ActionScript", 15, 0, 0, 7, 22
"/home/michal-wyszynski/Desktop/u connect reverse eng/uConnext/src/main_swf/events/VRSessionEvent.as", "ActionScript", 14, 0, 0, 6, 20
"/home/michal-wyszynski/Desktop/u connect reverse eng/uConnext/src/main_swf/events/ValetModeEvent.as", "ActionScript", 22, 0, 0, 7, 29
"/home/michal-wyszynski/Desktop/u connect reverse eng/uConnext/src/main_swf/events/WidgetEvent.as", "ActionScript", 40, 0, 0, 20, 60
"/home/michal-wyszynski/Desktop/u connect reverse eng/uConnext/src/main_swf/mx/utils/Base64Decoder.as", "ActionScript", 103, 0, 0, 16, 119
"/home/michal-wyszynski/Desktop/u connect reverse eng/uConnext/src/main_swf/mx/utils/StringUtil.as", "ActionScript", 197, 0, 0, 12, 209
"/home/michal-wyszynski/Desktop/u connect reverse eng/uConnext/src/main_swf/org/bytearray/gif/decoder/GIFDecoder.as", "ActionScript", 601, 0, 166, 101, 868
"/home/michal-wyszynski/Desktop/u connect reverse eng/uConnext/src/main_swf/org/bytearray/gif/encoder/GIFEncoder.as", "ActionScript", 283, 0, 125, 106, 514
"/home/michal-wyszynski/Desktop/u connect reverse eng/uConnext/src/main_swf/org/bytearray/gif/encoder/LZWEncoder.as", "ActionScript", 179, 0, 63, 91, 333
"/home/michal-wyszynski/Desktop/u connect reverse eng/uConnext/src/main_swf/org/bytearray/gif/encoder/NeuQuant.as", "ActionScript", 370, 0, 94, 205, 669
"/home/michal-wyszynski/Desktop/u connect reverse eng/uConnext/src/main_swf/org/bytearray/gif/errors/FileTypeError.as", "ActionScript", 10, 0, 0, 0, 10
"/home/michal-wyszynski/Desktop/u connect reverse eng/uConnext/src/main_swf/org/bytearray/gif/events/FileTypeEvent.as", "ActionScript", 12, 0, 0, 2, 14
"/home/michal-wyszynski/Desktop/u connect reverse eng/uConnext/src/main_swf/org/bytearray/gif/events/FrameEvent.as", "ActionScript", 15, 0, 0, 4, 19
"/home/michal-wyszynski/Desktop/u connect reverse eng/uConnext/src/main_swf/org/bytearray/gif/events/GIFPlayerEvent.as", "ActionScript", 15, 0, 0, 3, 18
"/home/michal-wyszynski/Desktop/u connect reverse eng/uConnext/src/main_swf/org/bytearray/gif/events/TimeoutEvent.as", "ActionScript", 12, 0, 0, 2, 14
"/home/michal-wyszynski/Desktop/u connect reverse eng/uConnext/src/main_swf/org/bytearray/gif/frames/GIFFrame.as", "ActionScript", 16, 0, 0, 2, 18
"/home/michal-wyszynski/Desktop/u connect reverse eng/uConnext/src/main_swf/org/bytearray/gif/player/GIFImage.as", "ActionScript", 70, 0, 0, 13, 83
"/home/michal-wyszynski/Desktop/u connect reverse eng/uConnext/src/main_swf/org/bytearray/gif/player/GIFPlayer.as", "ActionScript", 227, 0, 76, 55, 358
"/home/michal-wyszynski/Desktop/u connect reverse eng/uConnext/src/main_swf/peripheral/HardControls.as", "ActionScript", 369, 0, 2, 42, 413
"/home/michal-wyszynski/Desktop/u connect reverse eng/uConnext/src/main_swf/peripheral/Peripheral.as", "ActionScript", 596, 0, 0, 94, 690
"/home/michal-wyszynski/Desktop/u connect reverse eng/uConnext/src/main_swf/peripheral/PresetManager.as", "ActionScript", 238, 0, 0, 20, 258
"/home/michal-wyszynski/Desktop/u connect reverse eng/uConnext/src/main_swf/peripheral/VehicleFeatureManager.as", "ActionScript", 429, 0, 0, 119, 548
"/home/michal-wyszynski/Desktop/u connect reverse eng/uConnext/src/main_swf/peripheral/helper/SaveLoad_AIR.as", "ActionScript", 51, 0, 0, 6, 57
"/home/michal-wyszynski/Desktop/u connect reverse eng/uConnext/src/main_swf/peripheral/helper/StrbMapper.as", "ActionScript", 91, 0, 0, 12, 103
"/home/michal-wyszynski/Desktop/u connect reverse eng/uConnext/src/main_swf/pkgs/pkglist.xml", "XML", 0, 60, 0, 3, 63
"/home/michal-wyszynski/Desktop/u connect reverse eng/uConnext/src/main_swf/uConnext-app.xml", "XML", 0, 13, 337, 61, 411
"/home/michal-wyszynski/Desktop/u connect reverse eng/uConnext/src/main_swf/uConnext.as", "ActionScript", 136, 0, 1, 22, 159
"/home/michal-wyszynski/Desktop/u connect reverse eng/uConnext/src/musicapp_swf/MusicApp.as", "ActionScript", 247, 0, 1, 50, 298
"/home/michal-wyszynski/Desktop/u connect reverse eng/uConnext/src/musicapp_swf/musicapp-app.xml", "XML", 0, 10, 340, 61, 411
"/home/michal-wyszynski/Desktop/u connect reverse eng/uConnext/src/musicapp_swf/ui/ImageToggleBtn.as", "ActionScript", 51, 0, 0, 10, 61
"/home/michal-wyszynski/Desktop/u connect reverse eng/uConnext/src/musicapp_swf/ui/TriStateImgToggleBtn.as", "ActionScript", 59, 0, 0, 10, 69
"/home/michal-wyszynski/Desktop/u connect reverse eng/uConnext/src/systemui_swf/SystemUI.as", "ActionScript", 302, 0, 12, 55, 369
"/home/michal-wyszynski/Desktop/u connect reverse eng/uConnext/src/systemui_swf/systemui-app.xml", "XML", 0, 10, 340, 61, 411
"/home/michal-wyszynski/Desktop/u connect reverse eng/uConnext/src/testapp_swf/TestApp.as", "ActionScript", 51, 0, 0, 14, 65
"/home/michal-wyszynski/Desktop/u connect reverse eng/uConnext/src/testapp_swf/testapp-app.xml", "XML", 0, 10, 340, 61, 411
"Total", "-", 66349, 117, 7330, 14451, 88247