"filename", "language", "ActionScript", "comment", "blank", "total"
"/home/michal-wyszynski/Desktop/u connect reverse eng/uConnext/src/main_swf/com/uconnext/Core.as", "ActionScript", 384, 5, 44, 433
"/home/michal-wyszynski/Desktop/u connect reverse eng/uConnext/src/main_swf/com/uconnext/DeviceConfig.as", "ActionScript", 14, 0, 4, 18
"/home/michal-wyszynski/Desktop/u connect reverse eng/uConnext/src/main_swf/com/uconnext/Log.as", "ActionScript", 44, 4, 9, 57
"/home/michal-wyszynski/Desktop/u connect reverse eng/uConnext/src/main_swf/com/uconnext/PeripheralLoader.as", "ActionScript", 34, 1, 1, 36
"/home/michal-wyszynski/Desktop/u connect reverse eng/uConnext/src/main_swf/com/uconnext/SpeedLockout.as", "ActionScript", 238, 0, 4, 242
"/home/michal-wyszynski/Desktop/u connect reverse eng/uConnext/src/main_swf/com/uconnext/SystemUIEvent.as", "ActionScript", 7, 0, 0, 7
"/home/michal-wyszynski/Desktop/u connect reverse eng/uConnext/src/main_swf/com/uconnext/api/v1/Audio.as", "ActionScript", 497, 11, 112, 620
"/home/michal-wyszynski/Desktop/u connect reverse eng/uConnext/src/main_swf/com/uconnext/api/v1/GlobalVars.as", "ActionScript", 22, 5, 21, 48
"/home/michal-wyszynski/Desktop/u connect reverse eng/uConnext/src/main_swf/com/uconnext/api/v1/Vehicle.as", "ActionScript", 69, 9, 14, 92
"Total", "-", 1309, 35, 209, 1553